11111111111111111111111111111111111111111111111111
10000000000000000000666630000000000463400000000001
10000000000000000066600030000000004364000000000001
10304040000000000000600000300000004460430000000001
10330404000666666666666666300000004466666666640001
10030004000000000000000030032225003303030004000001
10040040000000040400000000052266666300000040000001
10040440000000040040000005552225553000000000000001
10000000003300004040000666222522225600000000044001
10000000003000000000000005222225444640000000000401
10600000000004054555500005244455040600066660000001
10600000000666662222500005442500000640000000000441
10600000000033052224400400454400304000000000344401
10000000000004032666660400666000443440000000000041
10000000000040042255400000400440003300000000300041
10000000000005532554336666600000333000000006666001
10000003000033226666600030000003033300000000334401
10030000000305424430303300000000000000000000000001
10000030303300554006666000000040400000000000300001
10000333033300444403333330000000000000000000000001
10000000400000000000000000000000000000000000000001
10000000000000000000000000000000000000000000000001
10000000000000000000000000000000000000000000000001
10066666666666666666666666666666666666666660000001
10000000000000000000000000000000000000000000000001
10000000000000000000000000000000000000000000000001
10000000000000000000000000000000000000000000000001
10000000000000000000000000000000000000000000000001
10000000444444444000000000000000000000000000000001
10000000000000000000000000000000000000000000000001
10000000000000000000000000000000000000000000000001
10000000000000003333300000000000000000000000000001
10000000000000000000000000000000000000000000000001
10000000000000000000000000000000000000000000000001
10000000000000000000000000000000000000000000000001
10000000000000000000000000000000000000000000000001
10000000000000000000000000000000000000000000000001
10000000000000000000000000000000000000000000000001
10000000000000000000000000000000000000000000000001
10000000000000000000000000000000000000000000000001
10000000000000000000000000000000000000000000000001
10000000000000000000000000000000000000000000000001
10000000000000000000000000000000000000000000000001
10000000000000000000000000000000000000000000000001
10000000000000000000000000000000000000000000000001
10000000000000000000000000000000000000000000000001
10000000000000000000000000000000000000000000000001
10000000000000000000000000000000000000000000000001
10000000000000000000000000000000000000000000000001
11111111111111111111111111111111111111111111111111