11111111111111111111111111111111111111111111111111
12222000000000000222222222222222222222222222222221
12222222922222222222222222222222222055555555500021
12222222922222222222222222222255555555550000000021
12555555555555555555555555555550444444444440000021
12077777770000000777777777777777000000000000000021
12000000004444444444444440000000000000000000000021
12000000044444400000000000000000000000000000000021
12000004444400444444400000000000000000000000000021
12000000000000000000000000000000000000000000000021
12000000077777777777700000000000000000000000000021
12000000000077777777777777777000000000000000000021
12000000000000000777777700000000000000000000000021
12000000000000007777777770000000004444444440000021
12000000777777777777700000000000000004444440000021
12000000000000000000000000000000004444444440000021
12000000000000000000000000000000000000333333333021
12000000000000000000003333333333333333000000000021
12000000000000000000003004444444440000000000000021
12000000000000000004443444444440000000000000000021
12000000000000000000003044444444444000000000000021
12000000000000000000333333333333330000000000000021
12222222222222222222922222222222292222222222222221
12222222222222222222922222222222292222222222222221
10000000000000000000000000000000000000000000000001
10000000555555555555355555555555555555555550000001
10000000555555555555555555555555555555555550000001
10000000555555555555535555555555555555555550000001
10000000555555555555555555555555555555555550000001
10000000555555555555553555555555555555555550000001
10000000555555555555555555555555555555555500000001
10000000055555555555555335333333333300000000000001
10000000005555555555500111111111111100000000000001
10000000000000000000000188888888888103000000000001
10000000000000000000000188888888888100300000000001
10000000000000000000000188888888888100000000000001
10000000000000000000000188888888888103000000000001
10000000000000000000000188888888888103330000000001
10000000000000000000000111188111111100000000000001
10000000000000000000000000333000000003300000000001
10000111111111000000333000000000000000000000000001
10000188888881003300000000000000000000000000000001
10000188888801003000000000000000000000000000000001
10000188888808003300000000000000000000000000000001
10000188888801000000000000000000000000000000000001
10000188888881000000000000000000000000000000000001
10000111111111000000000000000000000000000000000001
10000000000000000000000000000000000000000000000001
10000000000000000000000000000000000000000000000001
11111111111111111111111111111111111111111111111111

