11111111111111111111111111111111111111111111111111
12222222222222222222222222222222222222222222222221
12000000000000000000000000000000000000000000000021
12000000000000000000000000000000000000000000000021
12000000000000000000000000000000000000000000000021
12000000000000000005555555555555555555555555555521
12000000000000000005555555555555555555555555555521
12000000000000000005555555555555555555555555555521
12000000000000000000000000000000000000000000000021
12000000000000000000000000000000000000000000000021
10000000000000000000000000000000000000000000000001
10000000000000000000000000000000000000000000000001
10000000000000000000222222222222200000000000000001
10000000000000000000200000000000200000000000000001
10000000000000000000200009990000200000000000000001
10000000000000000000200000000000200000000000000001
10000000000000000000222222222222200000000000000001
10000000000000000000000000000000000000000000000001
10000777777777700000000000000000000000000000000001
10000700000007000000000000000000000000000000000001
10000708888807000000000000000000000000000000000001
10000708818807000000000000000000000000000000000001
10000708888807000000000000000000000000000000000001
10000700000007000000000000000000000000000000000001
10000777777777000000000000000000000000000000000001
10000000000000000000000000000000000000000000000001
10000000000000000000000000000000000000000000000001
10000000000000000000000000000000000000000000000001
10000000000000000000000000000000000000000000000001
11111111111111111111111111111111111111111111111111