1111111111111111
1022222222222201
1000222222220001
1000000222200001
1000000000000001
1000000000000001
1222200000000001
1002220000000001
1000002222000001
1000000000222221
1000000000000001
1111111111111111