11111111111111111111111111111111111111111111111111
12222222222222222222222222222222222222222222222221
12000000000000000000000000000000000000000000000021
12000000000000000000000000000000000000000000000021
12000000000000000000000000000000000000000000000021
12000000000000000000000000000000000000000000000021
12000000004444444444444440000000000000000000000021
12000000044444400000000000000000000000000000000021
12000004444400444444400000000000000000000000000021
12000000000000000000000000000000000000000000000021
12000000077777777777700000000000000000000000000021
12000000000077777777777777777000000000000000000021
12000000000000000777777700000000000000000000000021
12000000000000007777777770000000000000000000000021
12000000777777777777700000000000000000000000000021
12000000000000000000000000000000000000000000000021
12000000000000000000000000000000000000000000000021
12000000000000000000000000000000000000000000000021
12000000000000000000000004444444440000000000000021
12000000000000000004444444444440000000000000000021
12000000000000000000000044444444444000000000000021
12000000000000000000000000000000000000000000000021
12222222222222222222922222222222292222222222222221
12222222222222222222922222222222292222222222222221
10000000000000000000000000000000000000000000000001
10000000555555555555555555555555555555555550000001
10000000555555555555555555555555555555555550000001
10000000555555555555555555555555555555555550000001
10000000555555555555555555555555555555555550000001
10000000555555555555555555555555555555555550000001
10000000555555555555555555555555555555555500000001
10000000055555555555555555555000000000000000000001
10000000005555555555500222222222222200000000000001
10000000000000000000000200000000000200000000000001
10000000000000000000000200000000000200000000000001
10000000000000000000000299999999990200000000000001
10000000000000000000000288888888882200000000000001
10000000000000000000000288888888888200000000000001
10000000000000000000000222288222222200000000000001
10000000000000000000000000000000000000000000000001
10000777777777700000000000000000000000000000000001
10000700000007000000000000000000000000000000000001
10000708888807000000000000000000000000000000000001
10000708818808000000000000000000000000000000000001
10000708888807000000000000000000000000000000000001
10000700000007000000000000000000000000000000000001
10000777777777000000000000000000000000000000000001
10000000000000000000000000000000000000000000000001
10000000000000000000000000000000000000000000000001
10000000000000000000000000000000000000000000000001
10000000000000000000000000000000000000000000000001
11111111111111111111111111111111111111111111111111
